SO ./textures/wall_2.xpm






NO          ./textures/wall_1.xpm

F                           0,0,0

EA        textures/wall_4.xpm
WE           ./textures/wall_3.xpm 




C                 252,30,0

1111
1111      1111
 111      1111
10001    100001
1001      10001
1001  11 100011
1001 1001 10W001
1001 1001 10001
1001 1000100001
1111 1111 11111
