EA ./textures/wall_4.xpm
F 220,200,0

NO ./textures/wall_1.xpm
C 225,30,0
SO ./textures/wall_2.xpm
WE ./textures/wall_3.xpm 


1
1111    
   111111
        111111111111111111111111
        1000000000110000000000001
        1011000001110000000000001
        1001000000000000000E00001
111111111011000001110000000100001
100000000011000001110111111111111
111111111111111111111111111111111
11110111111111011110000010001
11110111111111011101010010001
1100000011111101100000010011
10000000000000001100000010001
10000000000000001101010010001
11000001110101011111000000111
11110101 11101010101111010001
1111111111111111111111111111