SO ./textures/wall_2.xpm
C 252,0,0
NO          ./textures/wall_1.xpm
F                                       100,15,100
EA        textures/wall_4.xpm
WE           ./textures/wall_3.xpm 
      1
1
1111
1111      11111
 111     111111
10001  1  100001
1001   1  10001
1001  11 100011
1001 1001 10W001
1001 1001 10001     
1111  1111111111
1001 1000100001
1111 111101111
         1


