NO ./textures/wall_1.xpm
SO ./textures/wall_2.xpm
WE ./textures/wall_3.xpm
EA ./textures/wall_4.xpm

F 220,111,119
C 225,111,0

 1111111111111111111111
10000000000000000000001
 1000000000000000000001
  10000000000000000001
   100000000S00000001
    1000000000000001
     10000000000001
      100000000001
       1000000001
        10000001
         100001
          1001
           11